// Level 2
// Lettuce go bois
// now we add two boxes (yes.)

🟦🟦🟦🟦🟦🟦🟦🟦🟦🟦🟦🟦
🟦⬛⬛⬛⬛⬛⬛⬛⬛⬛⬛🟦
🟦⬛🟧⬛⬛⬛⬛⬛⬛🟩⬛🟦
🟦⬛⬛⬛⬛⬛⬛⬛⬛⬛⬛🟦
🟦⬛⬛⬛⬛⬛⬛🟩⬛⬛⬛🟦
🟦⬛⬛⬛⬛⬛⬛⬛⬛⬛⬛🟦
🟦⬛⬛🟫⬛⬛⬛⬛⬛⬛🟫🟦
🟦⬛⬛⬛⬛⬛⬛⬛⬛⬛⬛🟦
🟦🟦🟦🟦🟦🟦🟦🟦🟦🟦🟦🟦